Амплификация — вложение в достижение цели больше усилий, чем необходимо, попытка «убить муху кувалдой». Например, чрезмерно детальное планирование в условиях отсутствия в достаточном объёме исходных данных и наличия сильно влияющих на результат неопределённых или случайных факторов.

Ускорение — выполнение работы со скоростью большей, чем необходимо или даже допустимо.

Опережение — неоправданно раннее начало действий по достижению цели.

Уклон в сторону поиска информации — тенденция искать информацию даже тогда, когда она не влияет на действия или результат.

Обобщение частных случаев — безосновательный перенос характеристик частных или даже единичных случаев на обширные их совокупности. Существует множество видов этого когнитивного искажения, классический вариант — теория заговора.

Эффект контраста — усиление или преуменьшение значения одного предмета, когда он сравнивается с только что обнаруженным контрастным объектом. Например, человек радуется тому, что купил недорого какую-то вещь в магазине, но перестаёт радоваться после того, как обнаруживает другой, малоизвестный магазин, в котором эта же вещь стоит в 2 раза дешевле.

Иллюзия частотности — недавно узнанная информация, появляющаяся вновь спустя непродолжительный период времени, воспринимается как необычайно часто повторяющаяся.

Отклонение в сторону результата — тенденция судить о решениях по их окончательным результатам, вместо того чтобы оценивать качество решений по обстоятельствам того момента времени, когда они были приняты («победителей не судят»).

Переоценка воздействия — тенденция людей переносить длительность или интенсивность воздействия некоего события на их будущие переживания.

Эффект фокусировки — ошибка в предсказаниях, возникающая, когда люди уделяют слишком много внимания какому-то одному аспекту явления; вызывает ошибки в правильном предсказании полезности будущего исхода. Например, концентрация внимания на том, кто виноват в возможной ядерной войне, отвлекает внимание от того, что пострадают в ней все.

Эффект сверхуверенности — тенденция переоценивать свои собственные способности.

Иллюзия контроля — тенденция людей верить, что они могут контролировать или, по крайней мере, влиять на результаты событий, на которые они на самом деле влиять не могут.

Предпочтение нулевого риска — предпочтение контролируемой, но потенциально более вредоносной (вследствие более частого её возникновения) ситуации перед обратной по причине переоценки возможности контроля. То есть человек со своей стороны считает, что он полностью избавляется от риска (на самом деле не имея полного контроля), в то время как со стороны статистики это является снижением лишь одного, не самого большого риска до нуля. Например, большинство людей предпочли бы уменьшить вероятность террористических актов до нуля вместо снижения аварийности на дорогах, даже если бы второй эффект давал больше сохранённых жизней.

Эффект Даннинга - Крюгера — люди, имеющие низкий уровень квалификации, делают ошибочные выводы, принимают неудачные решения и при этом неспособны осознавать свои ошибки в силу низкого уровня своей квалификации.

Искажение в восприятии сделанного выбора — излишнее упорство, привязанность к своему выбору, восприятие его как более правильного, чем он есть на самом деле, с дальнейшим его оправданием. Например, попытки найти неявные плюсы в покупке и тем самым оправдать её при наличии другого, более подходящего товара, который по каким-то причинам не был приобретён.

Эффект знакомства с объектом — тенденция людей выражать необоснованную симпатию к некоему объекту только потому, что они знакомы с ним (патриотизм, эффект причастности к созданию предмета).

Иррациональная эскалация — тенденция помнить свой выбор как более правильный, чем он был на самом деле.

Слепое пятно в отношении искажений — более лёгкое обнаружение недостатков у других людей, нежели у себя.

Ошибочность в духе меткого стрелка из Техаса — выбор или подстройка гипотезы под результаты измерений.

Предвзятость подтверждения — тенденция искать или интерпретировать информацию таким образом, чтобы подтвердить имевшиеся заранее концепции.

Эффект ожидания наблюдателя — бессознательное манипулирование ходом опыта для обнаружения ожидаемого результата.

Селективное восприятие — принятие во внимание только тех фактов, которые согласуются с ожиданиями.

Эффект обратного результата — склонность утверждаться в своей правоте вопреки свидетельствам, противоречащим исходному устоявшемуся убеждению человека. Из-за эффекта обратного результата бывает сложно переубедить собеседника в споре, если даже предоставлять ему сильные свидетельства, опровергающие его позицию.

Противление — проявление ментальной инерции, неверие в угрозу, продолжение прежнего курса действий в условиях настоятельной необходимости переключиться: когда откладывание перехода чревато ухудшением состояния; когда проволочка может привести к потере возможности улучшить ситуацию; при столкновении с экстренными ситуациями, неожиданными возможностями и внезапными помехами.

Эффект авторитета — тенденция приписывать более высокую оценку мнению авторитетной фигуры и в большей степени зависеть от этого мнения.

Приукрашивание прошлого — тенденция оценивать прошлые события более позитивно, чем они воспринимались в тот момент, когда на самом деле происходили.

«Проклятие знания» — затруднения у информированных людей при попытке рассматривать какую-либо проблему с точки зрения людей менее информированных.

Профессиональная деформация — психологическая дезориентация личности в ходе профессиональной деятельности. Тенденция смотреть на вещи согласно правилам, общепринятым для своей профессии, отбрасывая более общую точку зрения.

Эффект владения — завышение ценности покупки сразу после её приобретения. Его следствие — неприятие потери — отрицательная полезность, связываемая с потерей объекта, оказывается больше, чем полезность, связанная с приобретением его. Люди, зная пользу от принадлежащей им вещи, больше огорчаются от её потери, чем они радовались бы её находке, до которой они не думали об этой вещи и соответственно не учитывали её пользу.

Потребность в завершении и предпочтение целостных предметов — потребность достигнуть завершения в важном вопросе, получить ответ и избежать чувства сомнений и неуверенности. 

Эффект «меньше лучше»,  — при котором в отсутствие прямого сравнения предметов предпочтение отдаётся тому, который ближе к своему идеалу, несмотря на то, что его ценность меньше.

Регулирование — ловушка непрерывных приказов себе делать что-то, вместо того, чтобы иногда действовать импульсивно, спонтанно, когда это более приемлемо, при поиске чего-то нового, во время отпуска, отдыха.

Отклонение в сторону статуса кво — тенденция людей желать, чтобы вещи оставались приблизительно теми же самыми.

Эффект повального увлечения, конформизм — боязнь выделяться из толпы, тенденция делать вещи, потому что много других людей делают это. Относится к групповому мышлению, стадному поведению и маниям.

Затягивание (прокрастинация) — систематическое неоправданное откладывание, оттягивание начала неизбежной работы.

Недооценка бездействия — предпочтение большего вреда из-за бездействия, чем вреда из-за действия, вследствие непризнания вины в бездействии.

Эффект фрейминга — наличие зависимости выбора варианта решения от формы представления исходной информации. Так, изменение вида формулировки вопроса, с семантически идентичным содержанием, может вызывать изменение процента положительных (отрицательных) ответов с 20 % до 80 % и более. Существенную часть формы представления информации может образовывать отбор слов. 

Эффект псевдоуверенности — тенденция принимать решения, направленные на то, чтобы избежать риска, если ожидаемый результат позитивный, однако принимать рискованные решения, чтобы избежать негативного исхода.

Разделение — попытка выполнять одновременно два и более дела, требующих сознательного внимания, которое принципиально неделимо.

Формулирование — беспрерывное проговаривание своих мыслей о том, что кажется истинным.

Реверсия — систематический возврат к мыслям о гипотетических действиях в прошлом по предотвращению потерь, являющихся результатом произошедших необратимых событий, исправлению неисправимого, изменению необратимого прошлого. Формами реверсии являются вина и стыд.

Предвзятость относительно экономии времени — человеческая склонность к ошибочной оценке времени, которое может быть сэкономлено в результате увеличения скорости.

Ошибка планирования — тенденция недооценивать время выполнения задач, стоимость и длительность реализации проектов, особенно новых, сложных, больших, уникальных. Частный случай ошибки планирования нашел выражение в законе Мёрфи: «Всякая работа требует больше времени, чем вы думаете».

Сопротивление — потребность человека делать нечто противоположное тому, что некто побуждает его делать, из-за потребности противостоять кажущимся попыткам ограничить свободу выбора. При сопротивлении индивид часто действует себе во вред.

Потребность в противостоянии — попытки специально найти собеседника иного мнения для того, чтобы доказать ему своё.

Систематическая ошибка согласованности — тенденция проверять гипотезы исключительно путём прямого тестирования, пренебрегая косвенным или отвергая его.

Иллюзия конца истории — люди любого возраста считают, что их личность сильно изменилась в прошлом, но слабо изменится в будущем.

Искажение в оценке гомогенности членов другой группы — люди воспринимают членов своей группы как относительно более разнообразных, чем члены других групп.

Искажение в пользу своей группы — тенденция людей отдавать предпочтение тем, кого они считают членом своей собственной группы.

Искажение в связи с проекцией — тенденция бессознательно полагать, что другие люди разделяют те же, что и субъект, мысли, верования, ценности и позиции.

Эгоистическая погрешность — тенденция признавать большую ответственность за успехи, чем за поражения. Это может проявляться также как тенденция людей преподносить двусмысленную информацию благоприятным для себя образом.

Искажение при описании черт характера — тенденция людей воспринимать себя как относительно изменчивых в отношении личных качеств, поведения и настроения, одновременно воспринимая других как гораздо более предсказуемых. Например, иллюзия прозрачности — люди переоценивают способность других понимать их, и они также переоценивают свою способность понимать других.

Фундаментальная ошибка атрибуции — тенденция людей объяснять поведение других людей их личностными качествами, недооценивая ситуационные факторы, и в то же время переоценивать роль и силу ситуационных влияний на собственное поведение, недооценивая личностный аспект.

Эффект Лейк-Уобегон — человеческая тенденция распространять льстивые верования о себе и считать себя выше среднего.

Эффект ложного консенсуса — тенденция людей переоценивать ту степень, в которой другие люди соглашаются с ними.

Эффект ложной уникальности — недооценка индивидом распространённости среди других способностей и желательного или приносящего успех поведения, характерных для него.

Эффект эгоцентричности — он имеет место, когда люди считают себя более ответственными за результат неких коллективных действий, чем это находит внешний наблюдатель.

Гиперсемиотизация — состояние, когда люди начинают видеть несуществующие знаки.

Феномен «Дверь в лицо» — люди склонны идти на уступку и соглашаться с малопривлекательным предложением в том случае, если оно им предлагается сразу после их отказа от другой более обременительной просьбы.

Феномен «Нога в двери» — после выполнения изначально незначительной просьбы люди склонны соглашаться исполнять другие более обременительные требования.

Феномен «справедливого мира» — тенденция людей верить, что мир «справедлив» и, следовательно, люди получают «то, что они заслуживают».

Эффект Форера — тенденция высоко оценивать точность описаний своей личности, как если бы они были нарочно написаны специально для вас, но которые в действительности являются достаточно общими, чтобы их можно было приложить к очень большому числу людей. Например, гороскопы.

Эффект ореола — имеет место при восприятии одного человека другим и состоит в том, что позитивные и негативные черты человека «перетекают», с точки зрения воспринимающего, из одной области личности воспринимаемого человека в другую (см. также стереотип физической привлекательности).

Эффект первого впечатления — влияние мнения о человеке, которое сформировалось у субъекта в первые минуты при первой встрече, на дальнейшую оценку деятельности и личности этого человека. Причисляют также к ряду ошибок, часто совершаемых исследователями при использовании метода наблюдения, наряду с эффектом ореола и другими.

Искажение в связи с формулировкой закона — эта форма культурного искажения связана с тем, что запись некоего закона в виде математической формулы создаёт иллюзию его реального существования.

Эффект опознаваемой жертвы — тенденция оказывать более щедрую помощь отдельному индивиду (жертве), чьи затруднительные жизненные обстоятельства можно наблюдать напрямую, нежели неопределённой группе лиц с аналогичными проблемами.

Эффект первенства — тенденция переоценивать изначальные события более, чем последующие события.

Ошибка игрока — тенденция полагать, что отдельные случайные события испытывают влияние предыдущих случайных событий.

Иллюзия кластеризации — тенденция видеть паттерны там, где их на самом деле нет.

Ошибка выжившего — склонность недооценивать недоступные прямому наблюдению данные по группе «погибших».

Эвристика доступности — оценка как более вероятного того, что более доступно в памяти, то есть уклонение в сторону более яркого, необычного или эмоционально заряженного.

Ошибка полноты распределения — тенденция верить, что чем ближе среднее значение оказалось к заданному, тем у́же распределение набора данных.

Стереотипизация — ожидание от члена группы определённых характеристик без знания какой-либо дополнительной информации о его индивидуальности.

Ошибка базового процента — игнорирование или недостаточное использование основной априорной информации под влиянием специфики рассматриваемого случая.

Эффект недавнего (аберрация близости) — тенденция оценивать значение недавних событий выше, чем более ранних событий.

Искажение уже определённого места — тенденция запоминать себя самого как показавшего лучшие, чем у других индивидов, результаты в тех заданиях, наши способности в которых мы оцениваем как «выше среднего»; также и тенденция запоминать себя самого как показавшего худшие, чем у других индивидов, результаты в тех заданиях, наши способности в которых мы оцениваем как «ниже среднего».

Искажение, связанное с селекцией — искажение в экспериментальных данных, которое связано с тем, каким образом данные были собраны.

Каскад доступной информации — самоусиливающийся процесс, в ходе которого коллективная вера во что-то становится всё более убедительной за счёт нарастающего повторения в публичном дискурсе («повторяйте нечто достаточно долго, и это станет правдой»).

Отклонение в сторону позитивного исхода — тенденция переоценивать при предсказании вероятность хороших вещей.

Отклонение, связанное с вниманием — пренебрежение релевантной информацией при суждении о корреляции или ассоциации.

Ошибочность, связанная с играми — анализ проблем, связанных с выпадением шансов, с помощью узкого набора игр.

Функциональная закреплённость — использование предмета в каком-то одном качестве препятствует последующему использованию его в ином качестве в этой же текущей ситуации.

Хоторнский эффект — феномен, состоящий в том, что люди, наблюдаемые в ходе исследования, временно изменяют своё поведение или производительность. Пример: повышение производительности труда на заводе, когда приезжает комиссия по исследованию производительности труда на этом заводе.

Эффект знания задним числом — иногда называется «Я так и знал» — склонность воспринимать прошлые события предсказуемыми.

Эффект неоднозначности — избегание вариантов действий, в которых отсутствующая информация делает вероятность «неизвестной».

Иллюзорная корреляция — феномен восприятия преувеличенно тесной связи между переменными, которая в реальности или не существует, или значительно меньше, чем предполагается.

Эффект привязки — особенность принятия численных решений человеком, вызывающая иррациональные смещения ответов в сторону числа, попавшего в сознание перед принятием решения.

Эффект телескопа — этот эффект состоит в том, что недавние события кажутся более отдалёнными, а более дальние события — более близкими во времени.

Криптомнезия — форма неправильного установления авторства, когда за воспоминание ошибочно принимается результат воображения. Например, человеку может казаться, что он сам сочинил анекдот, в то время как в действительности он его уже слышал и просто вспомнил.

Эгоцентрическое искажение — воспоминание прошлого в самовозвеличивающей манере, например, воспоминание экзаменационных оценок лучшими, чем они были, а пойманной рыбы — большей, чем она была.

Ложная память — нарушения памяти, выражающиеся в ложных воспоминаниях.

Детская амнезия — очень слабая способность взрослых людей воспроизводить воспоминания периода жизни до 2—4 лет, может быть объяснена незрелостью мозговых структур — таких как гиппокамп и амигдалы, — отвечающих за кодирование и сохранение воспоминаний и достаточно развивающихся обыкновенно к двум годам.

Кажущееся постоянство — неправильное воспоминание чьих-либо прошлых позиций и поведения как напоминающих теперешние позиции и поведение.

Семантическое когнитивное искажение — суть которого заключается в тенденции полагать, что знаешь значение слова, хотя на самом деле знаешь лишь область его применения и употребления.

Эффект дезинформации — происходит, когда воспроизведение эпизодических воспоминаний становится менее точным из-за полученной пост-фактум информации. Является классическим примером ретроактивной интерференции, происходящей, когда информация, полученная позже, интерферирует со способностью сохранять ранее закодированную информацию.

Эффект уровня обработки — описывает вызов и воспроизведение воспоминаний о каком-либо стимуле как функцию глубины ментальной обработки: более глубокий анализ порождает более надежный и детальный и дольше существующий след в памяти, чем поверхностный анализ. Например, информация запоминается лучше, если она сгенерирована самим индивидом, а не прочитана или получена каким-либо другим способом извне.

Эффект самореференции — явление, при котором воспоминания, закодированные с отношением к себе, лучше вспоминаются, чем аналогичная информация безотносительно к себе.
